The Bad Guys Win
MaxSteps = 500
NumShells = 20
Rows = 15
Cols = 20
 #@       @ # @   # 
   #@#  ##  @       
      @          # @
# # @   # @@        
@    #  2           
   @# @#   #    #@ @
         #@ #@    # 
 @#   #   @###  #   
 # #  ##  2#       #
  #  #      1 ##2   
    ##          @  #
#   #         ###   
   ### # #1 @ @   ##
# @    # #  @ #@@#  
 1 #@## @         #@
